0 2 1 0 0 4 8 3 0 
4 0 3 5 0 8 2 0 1
0 6 0 1 3 0 0 0 0
0 9 2 0 7 0 5 4 0
1 0 5 3 0 0 0 0 0
0 0 7 0 0 0 0 0 8
0 5 0 0 2 0 3 0 0
2 3 0 0 0 0 0 8 6
7 1 0 6 8 3 4 5 2