4 6 7 0 0 5 0 0 0
0 5 0 1 0 0 7 0 0
0 0 0 0 4 7 0 3 6
9 1 0 2 0 6 0 5 0
0 0 8 4 0 9 3 0 0
0 7 0 3 0 8 0 9 2
7 9 0 5 8 0 0 0 0
0 0 2 0 0 3 0 7 0
0 0 0 7 0 0 1 6 9